apple 	fifth 	scale
arithmetic 	finger 	seashore
badge 	flock 	sidewalk
basket 	frame 	sleet
basketball 	furniture 	smoke
battle 	geese 	bathtub
beast 	ghost 	nose
beetle 	giraffe 	sidewalk
beggar 	governor 	boy
brain 	honey 	stage
bubble 	hope 	station
bucket 	income 	throat
cactus 	island 	throne
cannon 	jeans 	title
cow    	judge 	toothbrush
celery 	lamp 	turkey
cellar 	lettuce 	umbrella
cloth 	marble 	underwear
coach 	month 	vacation
coast 	north 	vegetable
crate 	ocean 	poison
cream 	patch 	riddle
girl 	  plane 	scale
donkey 	playground 	visitor
earthquake 	poison 	voyage
feast 	riddle 	year